converterClass	com.equalize.xpi.af.modules.deepfcc.DeepPlain2XMLConverter
documentName	MT_DeepPlain2XML
documentNamespace	urn:equalize:com
recordsetStructure	Header,Delivery,Order,Item
keyFieldName	Type
Header.fieldNames	Type,FileName
Delivery.fieldNames	Type,DeliveryNo,Dummy
Order.fieldNames	Type,DeliveryNo
Item.fieldNames	Type,OrderNo,ItemNo,Quantity
Header.keyFieldValue	H
Delivery.keyFieldValue	D
Order.keyFieldValue	O
Item.keyFieldValue	I
Header.parent	Root
Delivery.parent	Root
Order.parent	Delivery
Item.parent	Order
Header.fieldFixedLengths	5,20
Delivery.fieldFixedLengths	5,10,10
Order.fieldFixedLengths	5,10
Item.fieldFixedLengths	5,10,10,10
trimContents	N
indentFactor	2
//Delivery.missingLastFields	error
Order.additionalLastFields	error